R 500 500


        NO    ./textures/redbrick.xpm


 SO     ./textures/redbrick.xpm    


  WE   ./textures/redbrick.xpm 


   EA  ./textures/redbrick.xpm   


S ./textures/barrel.xpm


F 150, 50, 50
C 0, 150, 255

        1111111111111111111111111
        1000000000110000000000001
        1011000001112002002002001
        1001000000000000000000001
111111111011000001110000000000001
100000000011000001110111110111111
11110111111111011100000010001
11110111111111011101010010001
11000000110101011100000010001
10002000000000001100000010001
10000000000000001101010010001
11000001110101011111011110N0111
11110111 1110101 101111010001
11110111 1110101 101111010001
11110111 1110101 101111010001
11110111 1110101 101111010001
11110111 1110101 101111010001
11110111 1110101 101111010001
11110111 1110101 101111010001
11110111111101011101111010001
11110000000000000000000000001
11111111111111111111111111111