R 1000 500

NO ./textures/redbrick.xpm
SO ./textures/bluestone.xpm
WE ./textures/colorstone.xpm
EA ./textures/greystone.xpm

S ./textures/barrel.xpm

F 220,255,230
C 255,30,0

111111111111111111111111111111111
100222001000000000110000000000001
100000001011000001110020002002001
100000000001000000000000000000001
111111111011000001110000000000001
100000000011000001110111110111111
11110111111111011100000010001
11110111111111011101010010001
11000000110101011100000010001
11000000110101000000000010001
11002000110101011100000010001
11000000110101011100000010001
11000000110101011100000010001
10002000000000002000000010001
10000000000000001101010000001
1100N00111010101111101111000111
11110111 1110101 101111010001
11111111 1111111 111111111111