      R   500 500
    C   143,     201,   217
    F    153, 191, 147
NO   ./textures/bluestone.xpm
SO ./textures/redbrick.xpm
WE ./textures/mossy.xpm
EA ./textures/colorstone.xpm
S ./textures/barrel.xpm



                                                                      111111111
11111111111111111111111111111111111111111111111111                    100200001
1000000000000000200000000012221000000000000110002111111111111111111111100002001
1000000000002000000000000012221000000000000010200000000000000000000000000000021
1000000002000000000000000000000000000000000000000111111111111111111111100000201
100000000000122210000000000000000000000000001N1001                    100200021
10000000000012221000000000000000000000000001101001                    111111111
11111111111111111111111111111111111111111111111111